Username	Name	Match? Y/N																							
Tristan1369	Jordan  Hines	1																							
catherinevandeh	Catherine Ann	0																							
EveShead	Eve Shead	0																							
mschreiweis66	Michael Schreiweis	1																							
Shawtypepelina	n/a	0																							
jeanniejinjin	JJ	0																							
HPB57	EX Dem from Ohio	0																							
MyInfojoeybray1	Deplorable patriot	1																							
Boyd_2650	Diane Boyd	0																							
scroarty	Sharon Lee	0																							
DonnaPeterson4	n/a	0																							
IAH737driver	n/a	1																							
dawnz01	Dawn Starz	0																							
gringaloca11	victoria jenkins																								
LexCalifornia	Alex Casey																								
anbarber1980	Adam N Barber																								
Lessie1962	n/a																								
GiiMarias	gii marias																								
KDScioscia	Karen D. Scioscia																								
RightSassy	n/a	0																							
DuffiF	Duffi Lee Frazier	1																							
TheRealPopeyeO	Robert Olmstead	1																							
tmj_ks_vets	KS Veteran Jobs	0																							
EnergizeVets	Mike Wms	1																							
ValorOf1776	Wilhelm Von R”mer	1																							
Pat_Donnachie	Pat Donnachie	1																							
BethanyJuno	n/a	1																							
Red_Baron63	n/a	0																							
OldManStoneZone	n/a	1																							
JEHutton	James Hutton	1																							
s_gd_usa	S GD	0																							
glolara	Gloco	1																							
WarriorofGod97	n/a	0																							
TCuccio	n/a	0																							
APTT45Babe	n/a	0																							
Ancientbob	Bob Foss	1																							
aligiarc	giarca	0																							
TurnKyBlue	Turn Ky Blue	1																							
GreatLaker1066	David	0																							
216Zealot	Oh_216Zealot_iO	1																							
HVeteran03	HerbaVeteran03	1																							
Sapper864	'Mack' McKie	1																							
SonieNcmrs	SonieNCmrs	0		Maybe have qualifiers to prevent this type of match																					
ElizaLynnArroy1	Eliza Lynn	0		TEST FOR FAMILY MEMBERS																					
MaryVi2020	Marivi2020	0																							
tmj_phl_vets	Phl Veteran Jobs	0		TEST FOR JOB ACCOUNTS																					
MeganSmiles	The Media Lies	0																							
bobsbabie1965	n/a	0																							
NavyWords	Navy Words	0																							
DushawnMoses	I love my God	1																							
nomarxism21	nomarxism2	0																							
tmj_wi_vets	WI Veteran Jobs	0																							
klasinz	TruthHunter	0																							
jsdr57	call me...JIM	0																							
Nottherealme1	B	0																							
caterinagrove	GRANDMA 2 ARMYMEDIC	1																							
toombstone	n/a	0																							
veritaz	God?Country?Israel	dne																							
novelpulse	n/a	0																							
FreedomFlagship	n/a	1																							
tmj_mt_vets	MT Veteran Jobs	0																							
Magade18	n/a	0																							
bubba_rffr	Kevin W	0																							
4TrumpMovement	*ShadowBanned for Muting Rude Liberals*	0																							
moenjonh	Moenjonh	0																							
graceisnotgiven	Grace is not Given	0																							
lulucabeza	Lulu Cabeza	0																							
ou812usa	Han Valen	1																							
tgpekarek	Tim	0																							
NuecesThankAVet	Thank A Veteran	0																							
BigThom61	Thomas	0																							
tessyto	n/a	0																							
ThatsMsSandy2U	Sandy Hamilton	0																							
wendyblessed629	Deplorable Wendy	0																							
Uncannie1	TheUncannie1	1																							
BadLarryJr	Lawrence Deis Jr.	1		Issue with false reporting																					
radrep	Centinel	1																							
tmj_ny_vets	NY Veteran Jobs	0																							
GunnyP80	GunnyP	1																							
MIdifference2	n/a	0																							
stonemanatl	Stoneman18	0																							
ST1200Girl	ST1200Girl	1																							
jb29pdx	n/a	1																							
tmj_sc_vets	SC Veteran Jobs	0																							
bijasi83	Bill Simmons	1																							
Homimp1	NH.DAVE	1																							
Italians4Trump	Italians For Trump	0																							
KLelevier	k	0																							
1ChristWarrior	Christ Warrior	1																							
Brendag38323989	#TRUMPWINS4USA																								
Le123Ing	Le Ing																								
Bushie_40	Bushie_40 TTV																								
AirForce_Carl	Carl																								
southernlady111	Eden																								
sld_maga	Jason The Russian																								
RgnPetkeeper	Petkeeper																								
Sparks1Sharon	Sharon Sparks																								
BlueSea1964	Bluestar																								
LizOBrien30	Elizabeth L. O'Brien																								
tmj_fl_vets	FL Veteran Jobs																								
karenlmw	Karen Williams																								
tmj_AZ_vets	AZ Veteran Jobs																								
afterthedd214	After the DD-214																								
Veteran4Trump	Veteran For Trump																								
UghToHillary	AmericanMade																								
JosephMRyan1	Joe Ryan (Army Dad)																								
toruk_san	TheShadowKnows																								
bernardburney	Bernard Burney																								
ScottAulde	n/a																								
MichelleMascia3	n/a																								
MAGAGwen	n/a																								
MichalDouglas9	Michal Douglas																								
WeThePe65199714	We The People																								
legionbirdman	Robert White																								
TrmpPnceMkeSens	'Trump45'JPSavvy																								
tmj_mia_vets	Mia Veteran Jobs																								
1SemperFi_Girl	Bridgette Hawkins																								
sportsfan_james	Jim Carpenter																								
jasoncisneroz	Jason Cisneroz																								
tmj_hou_vets	Hou Veteran Jobs																								
DavidClardy6	David Clardy																								
ltwist1	Twisty Girl																								
oregonveteran	Oregon Veteran																								
tmj_AR_vets	AR Veteran Jobs																								
MTKHorses	n/a																								
vikramwkarve	Vikram Waman Karve																								
Pamela_O_Plays	Amphitrite Plays																								
chargergreg1	Greg Covfefe																								
packr66	Big Kev																								
MakeupBySiana	Siana																								
tmj_AL_vets	AL Veteran Jobs																								
Trump_U_Up	Trumped U Up!																								
lfbill	Bill Grant																								
whetzel_fred	Fred Allen Whetzel Jr																								
1BamBamtogo	Bambam																								
mrbob4u	bob hanrahan																								
alaphiah	alaphiah																								
mineisC	n/a																								
Chacowaco1	n/a																								
RLiberalskiddin	n/a																								
TonyaS30305	Tonya Satterwhite MAGA																								
DerekWadeWeller	DerekWeller																								
jsweitz61	J Q																								
R_del_Mar	Divergent-USA																								
tmj_il_vets	IL Veteran Jobs																								
HarleyandGuns	n/a																								
SarahPa36858880	Sarah Parker																								
Ynot101	n/a																								
rutavala1	Bobby Darrell Watt																								
andyoaklee	n/a																								
tmj_sd_vets	SD Veteran Jobs																								
theoldlabrat	Chris Murdock																								
BryonnyM	n/a																								
CanoninD222	CanoninD222																								
yorkietommo	n/a																								
wonthunt	Old Dawg																								
multisarcasmic	Goldilox																								
wmdtek	K																								
teapartypathq	Tea Party Patriot HQ																								
BethMSH_	n/a																								
AliceCAKANicki2	Alice C AKA Nicki Mc																								
OneVoiceUS	n/a																								
Pjxport3	PJ Sanchez																								
tmj_ia_vets	IA Veteran Jobs																								
venturer1200	Derek J. Johnson																								
hah0921	hhamberg																								
JoeyEDawes	n/a																								
nig_bell	Nigel Bell																								
vets2cloud	VETS2CLOUD ?																								
neonSponge	Chief Neon Sponge																								
JAmy208	Juliet Amy																								
tapp_wade	Wade Tapp #MAGA																								
tmj_ut_vets	UT Veteran Jobs																								
NeverHerorHim	n/a																								
MrsESK	n/a																								
joepaulrod	Jr																								
curb67	Whiskey Tango Foxtrot																								
myveteran	My Veteran																								
VeteranOnMove	Veteran On The Move																								
cindyloufun	cindyk																								
tmj_la_vets	LA Veteran Jobs																								
Lenardhscott101	n/a																								
KeelsUS	KeelsUS																								
KristiWoodruff3	Kristi Woodruff																								
minemantate	That Guy																								
onemattjansen	Dave M																								
McDoodle_Pj	n/a																								
Annadellia123	Annadellia																								
KSSchaack	KSS																								
maggiecas	God has given hope!																								
tmj_ky_vets	KY Veteran Jobs																								
KimberlyDehoff	Kimberly DeHoff																								
demsnomore	Johnny United																								
Yabadabado15	Yabadabado																								
FFRNewsNet2	FreedomFighterReport																								
TonyaLeeOrtega1	Tonya Lee Ortega																								
RidgeReaper68	Reaper][][][%																								
Revolutoin1800	REVOLUTION1800																								
robertleefrye	Robert Lee Frye																								
CatbirdCityPoet	CatbirdCityPoet																								
Shanna1627	Shanna g																								
WilliamNSmith3	William N Smith																								
codeofvets	Gretchen Smith																								
Prayformetoo	Anne																								
HappyPanda826	Trash Panda																								
Goz_1911	n/a																								
Neptunes455	n/a																								
Rogueraidr	n/a																								
HabuTroy7777777	Troy																								
billdodgeusa	Bill																								
wethepeople46	wethepeople46																								
_IamAnita_	n/a																								
M_CAT187	Martin																								
DwightCooper16	kissmybot																								
Daphene23058240	Daphene																								
dekerain1	Deke Raine																								
TimHall5569	Tim Hall																								
CanadayGeo	geo canaday																								
IncaOrchidLove	n/a																								
Janethecrusader	JG																								
scottwwilson07	n/a																								
ckemp1542400	Crystal kemp																								
bmiles2000	Bryan Miles																								
zacharyebell	Zachary Bell																								
vermont46	n/a																								
PHOEN1X_SQUARED	rxglenn																								
supernurse962	Cindy Leonard																								
tmj_pa_vets	PA Veteran Jobs																								
TrumpChess	#TrumpPatriot																								
camanowa	n/a																								
POLITICSandFUN	n/a																								
HH_kathy	n/a																								
Pets4Trump	Pets4Trump																								
Michaelingram84	KyloRenThaBoss (USMC Ret.)																								
SavvyHuman	GG Smiles																								
2Ckm72	cindy																								
DavidRomeiPHD	Dr. David Romei																								
mimiinftworth	Bloodhound																								
VoteIndpndt	ColTim																								
bbl58	Barbara Soliz																								
hirschA8720	n/a																								
tmj_ga_vets	GA Veteran Jobs																								
Nhlearning_Jobs	NH Learning Group																								
truthdetector45	In Trump We Trust																								
Trey_VonDinkis	Trey Von Dinkis																								
SVcaVet	n/a																								
woodardjba	Joshua																								
clutch14	Clutch																								
wallstr0ckstar	LionHeart																								
Dee601	Dee																								
scollins4945	Steven Collins																								
_ROB_111	n/a																								
DianaBialkowski	Diana Bialkowski																								
DMRichardson71	Darrell Richardson																								
SheriMamaGG3	Sheri*DontBlameMeIWroteInGeorgeCarlin92&96*MamaGG3																								
EmpiricalGuru	n/a																								
DandelionDollar	n/a																								
Nophir	Dave C																								
mtenorio77	Michael Tenorio																								
Barnett20Todd	Todd Barnett20																								
freeotz57	Frank Addicks																								
tmj_mo_vets	MO Veteran Jobs																								
ScannerMan563	n/a																								
Davidabcdfg	n/a																								
MrBeiss	Paul Beiss																								
tmj_chi_vets	Chi Veteran Jobs																								
GabbyInCa	n/a																								
AprilDay365	n/a																								
tmj_mi_vets	MI Veteran Jobs																								
navyvet50	Diane																								
rremmy72	Richard Remmy																								
TxVeteransROC1	Outreach Coordinator																								
JamesS020770	J Starr																								
chillinginLV	LV Deplorable																								
BrianWi63866040	Brian Wilson																								
BFD1982USN	BFD USN																								
cowboytay1	Tay (Cowboy/Lakers)																								
proseccopam77	n/a																								
LVNancy	n/a																								
WvTrump	n/a																								
hastings450f4	n/a																								
AirForceWords	Air Force Words																								
PaulConservativ	Paul theConservative																								
floridadaring	sick of government																								
cindyboyenga	n/a																								
HarrellRyan1	*Harrell Ryan*																								
DorAnnCecil	Deplorable DOR																								
DarkEagle215	Swamp Watch (PatrioticallyCorrect)																								
Pao1aChavez	Difficult_Truthful																								
rangermig	Micheal Migliara																								
some1elsesmom2	n/a																								
lonestartxMary	Mary Schnaubelt																								
RoeMasterNYC	n/a																								
TomPrigg2018	Tom Prigg 4 Congress																								
Sappermackie	Christopher D Mackie																								
wmleemert	Wm. Lee Merritt																								
2Corinthians4_6	Michael J Adams																								
Ohio_Buckeye_US	n/a																								
usa_rattlesnake	n/a																								
RedPilledinNY	RedPilled																								
WantBigHammer	WantBiggerHammer																								
artimusmaximus	Artimus Maximus																								
rigsby_michelle	n/a																								
wishbonerussian	n/a																								
tmj_tx_vets	TX Veteran Jobs																								
ToddFitchette	Todd Fitchette																								
CheriF53490591	n/a																								
Tat2uRdWhteBlu	Ms Mick																								
skyeleo	n/a																								
SyracuseOVMA	Syracuse OVMA																								
tmj_vets	Veteran Jobs																								
jimmyjjohnson99	jimmyjjohnson																								
kingright4u	JC																								
HandicapLaMont	Handicap LaMont																								
tmj_atl_vets	ATL Veteran Jobs																								
hankarnold54	Hank Arnold																								
NickASAVet	Nick Plessas																								
DonsAudrey	MilitaryMom																								
TimScranton2	n/a																								
OftedalEric	Eric Oftedal																								
momofmonday	gab.ai/Momofmonday																								
cjgrisham	CJ Grisham																								
mcrnc1	M.C.																								
jquigley2	jquigley2																								
HCOVSO	HuronCoVetServices																								
amx1	Randal Stone																								
tmj_CA_vets	CA Veteran Jobs																								
TheDanielMarch	Daniel March																								
MarcConners	n/a																								
Scott_C_Young	n/a																								
bob_simonson	Bob Simonson																								
tmj_wde_vets	Wilmington Veterans																								
eman1047	Errol E-Man Eaton																								
m_lonz	Mark Lonzo																								
vazr00	Rebecca Vazquez																								
vjoycejkl	Valerie																								
JiffyJaffe	n/a																								
FightFreeSpeech	Fight4FreedomOfSpeech																								
gemmah1776	gab.ai/gemmah1776																								
flgal4trump	Mercyme																								
VeteransUK	VeteransUK																								
JoAnnEileen	TheGoodWife																								
Debrina122	Debra Albrecht																								
ncar999	NaCaMo																								
navgirl63	n/a																								
Grey_Avenger	rxglenn																								
grpalmer01	Glenn Palmer																								
ACatholicKnight	Deplorable KEVIN																								
jon55021593	Jon5502 MAGA																								
imrayrod	RayRod																								
DavidMartin4NH	n/a																								
PoeticPastries	Pansylee VanMeteren																								
FreedomChild3	((( Faith )))																								
FITN1854	First In The Nation																								
MaryMkd12	Mary D																								
MakeNEGrrAgain	Make NE Great Again																								
JanAMVETS	Jan Brown																								
TheMsDlr	Deplorable Diana																								
JewelsMAGA	n/a																								
Warriors4Sierra	n/a																								
UberDick	Uber Dick																								
jilladairmakeup	Jilladair																								
I_am_Niteangel	Angelmyst																								
dmzveteran	DMZ Veteran																								
LaneSadalup	Sharon Lane																								
AndiBear128	n/a																								
VANorthTexas	VA NorthTexas																								
EjHirschberger	Erin'sTrump?																								
LolaJeep47	Dena Brown																								
LewadowskiLee	David Lewis																								
OzzieMAGAossie	n/a																								
flyover62	Randy																								
SRKENNEDY64	PATRICK J KENNEDY SR																								
bgood12345	dolce																								
concept268	Braddad																								
CharityFielder	n/a																								
intellivoice	Jeffro																								
soniajanet27	SJT																								
SKYRIDER4538	n/a																								
JohnMcGeever70	n/a																								
darrylb3812	Nope																								
ShaulIlaria	Shaul David																								
lionsmds	Mark Susor																								
crl_resist	CRLane																								
dprite1	n/a																								
clcbeing	ChristyC																								
busylizzie48	n/a																								
GrizzleMeister	GRIZZLE																								
Digitally_Your	Kent Graham																								
IIV_UK	InvestorsInVeterans																								
Mamasnothappy	Mama																								
Debbietazz	Deplorable Debbie																								
bmal1623	MERMER																								
T_W_Haines	T.W. Haines																								
AbnRngrJim	James P Spencer																								
DaGodfather77	#@Trumpsterfire																								
LynGirlCL	Cheri C																								
RobertD89815787	Robert Davis																								
politstrip	n/a																								
LoriWill213	n/a																								
DrMcKuKu	joseph cotton																								
sjBaldwin7	n/a																								
pammichelle1	n/a																								
MisteCaulder	My PRES is TRUMP																								
tmj_nd_vets	ND Veteran Jobs																								
Krystal96852465	Krystal Phillips																								
tmj_nj_vets	NJ Veteran Jobs																								
nickelintexas	Jeff Hensley																								
CareForTroops	BrookfieldInstitute																								
Domini_Templari	Dominici																								
Sheila4USA	n/a																								
Catfur98	#CatFur4Trump ?																								
MichDeplorable	n/a																								
RhondaStroud10	Rhonda Stroud																								
dalepalmersr	dale a palmer sr																								
KRoadhog	"Kevin ""Roadhog"" Trump"																								
ALD9119	ALD9119																								
Huck_Fillary_	Huck Fillary																								
Arl926	Angie Wood																								
ShowTheMEMO	ReleaseTheMEMO																								
ALprogressive1	AL progressive																								
VETERANSCHARITY	The Veterans Charity																								
AnneCLindsay	AnneMaga																								
greenlightgg	n/a																								
unfit2serve	Article XXV Sec 4																								
RealMarquis7	n/a																								
CharlesPRiley2	Pat Riley																								
JanosAuddron	Raziel																								
RoberRenteria	n/a																								
debra_giese	n/a																								
CAPT_Mike26	CAPT_3																								
WMSSVF	Wayne Metro SSVF																								
Danny4denise	n/a																								
bo_1961	bob tyrrell																								
GaryLeeMoreland	Gary Lee Moreland																								
gott_arun	Arun John Gott																								
fosterxcellence	FosteringExcellence																								
nearmis	michelle																								
MADE__USA	n/a																								
Pvt_Lesson	Clutch Cargo																								
Dragonsnestling	Lisa A Merrick																								
libertyraven	Danny for Trump																								
NLTCNY	Daisy's can opener																								
VF24Ordie	n/a																								
tmj_in_vets	IN Veteran Jobs																								
RobieRobotJr	Robbie Robot Jr.																								
jwest46568843	Well AighTy Then																								
																									
																									
																									
																									
																									
																									
																									
																									
																									
																									
																									
																									
																									
																									
																									
																									
																									
																									
																									
																									
																									
																									
																									
																									
																									
																									
																									
																									
																									
																									
																									
																									
																									
																									
																									
																									
																									
																									
																									
																									
																									
																									
																									
																									
																									
																									
																									
																									
																									
																									
																									
																									
																									
																									
																									
																									
																									
																									
																									
																									
																									
																									
																									
																									
																									
																									
																									
																									
																									
																									
																									
																									
																									
																									
																									
																									
																									
																									
																									
																									
																									
																									
																									
																									
																									
																									
																									
																									
																									
																									
																									
																									
																									
																									
																									
																									
																									
																									
																									
																									
																									
																									
																									
																									
																									
																									
																									
																									
																									
																									
																									
																									
																									
																									
																									
																									
																									
																									
																									
																									
																									
																									
																									
																									
																									
																									
																									
																									
																									
																									
																									
																									
																									
																									
																									
																									
																									
																									
																									
																									
																									
																									
																									
																									
																									
																									
																									
																									
																									
																									
																									
																									
																									
																									
																									
																									
																									
																									
																									
																									
																									
																									
																									
																									
																									
																									
																									
																									
																									
																									
																									
																									
																									
																									
																									
																									
																									
																									
																									
																									
																									
																									
																									
																									
																									
																									
																									
																									
																									
																									
																									
																									
																									
																									
																									
																									
																									
																									
																									
																									
																									
																									
																									
																									
																									
																									
																									
																									
																									
																									
																									
																									
																									
																									
																									
																									
																									
																									
																									
																									
																									
																									
																									
																									
																									
																									
																									
																									
																									
																									
																									
																									
																									
																									
																									
																									
																									
																									
																									
																									
																									
																									
																									
																									
																									
																									
																									
																									
																									
																									
																									
																									
																									
																									
																									
																									
																									
																									
																									
																									
																									
																									
																									
																									
																									
																									
																									
																									
																									
																									
																									
																									
																									
																									
																									
																									
																									
																									
																									
																									
																									
																									
																									
																									
																									
																									
																									
																									
																									
																									
																									
																									
																									
																									
																									
																									
																									
																									
																									
																									
																									
																									
																									
																									
																									
																									
																									
																									
																									
																									
																									
																									
																									
																									
																									
																									
																									
																									
																									
																									
																									
																									
																									
																									
																									
																									
																									
																									
																									
																									
																									
																									
																									
																									
																									
																									
																									
																									
																									
																									
																									
																									
																									
																									
																									
																									
																									
																									
																									
																									
																									
																									
																									
																									
																									
																									
																									
																									
																									
																									
																									
																									
																									
																									
																									
																									
																									
																									
																									
																									
																									
																									
																									
																									
																									
																									
																									
																									
																									
																									
																									
																									
																									
																									
																									
																									
																									
																									
																									
																									
																									
																									
																									
																									
																									
																									
																									
																									
																									
																									
																									
																									
																									
																									
																									
																									
																									
																									
																									
																									
																									
																									
																									
																									
																									
																									
																									
																									
																									
																									
																									
																									
																									
																									
																									
																									
																									
																									
																									
																									
																									
																									
																									
																									
																									
																									
																									
																									
																									
																									
																									
																									
																									
																									
																									
																									
																									
																									
																									
																									
																									
																									
																									
																									
																									
																									
																									
																									
																									
																									
																									
																									
																									
																									
																									
																									
																									
																									
																									
																									
																									
																									
																									
																									
																									
																									
																									
																									
																									
																									
																									
																									
																									
																									
																									
																									
																									
																									
																									
																									
																									
																									
																									
																									
																									
																									
																									
																									
																									
																									
																									
																									
																									
																									
																									
																									
																									
																									
																									
																									
																									
																									
																									
																									
																									
																									
																									
																									
																									
																									
																									
																									
																									
																									
																									
																									
																									
																									
																									
																									
																									
																									
																									
																									
																									
																									
																									
																									
																									
																									
																									
																									
																									
																									
																									
																									
																									
																									
																									
																									
																									
																									
