Username	Name	Match? Y/N																							
SapperE847	SapperE8	1																							
FIGHTINGVETERAN	THE MILITARY MATTERS	1																							
AlexN1952	n/a	1																							
ThomasBeaver9	Tom B	1																							
Rabidus_Umbra	n/a	0																							
Sugarshorts1965	Sugar Shorts	0																							
flybull1	Mike Mack	1																							
LifeJourneyOKC	KG-B Sooner 4 Trump	0																							
Sheila4USA	n/a	0																							
Z51vett	Marine	1																							
mal620	wheres_that_meteor	1																							
Obamaisnuts	America Returns	0																							
keck1157	Chris  Keck	1																							
RLiberalskiddin	n/a	0																							
army_ron	Army Ron	1																							
TChadbourne	Traci Chadbourne	0																							
CB618444	n/a	0																							
SmartWomenTrump	SmartWomenForTrump	0																							
Truth_Sirum	Khaotic Reign	0																							
RUaMonkeysAss	Jay	0																							
FuriousFarmBoy	JustKen	1																							
chuckrachel97	chuck Taylor	1																							
Chicago1Ray	n/a	0																							
tmj_vets	Veteran Jobs	0																							
neilcevans	Neil C Evans	0																							
Trey_VonDinkis	Trey Von Dinkis	1																							
Crosbyequipment	Jerome Crosby	0																							
cajunhusker	Huskerboy	1																							
tambid1	tammyb	0																							
josephnavaid	Joseph	1																							
bsgirl2u	n/a	0																							
CoreySm01384827	Corey Smith	1																							
ReloadDepot	n/a	0																							
John_Prevette	John Prevette	1																							
dontcavitate	Run Silent	1																							
coastin42	Cali4Trump	0																							
JEHutton	James Hutton	1																							
BFD1982USN	BFD USN	0																							
TerriGreenUSA	Terri Green	0																							
Veterans2011	Veterans2011	1																							
BillNigh	Bill Nigh	1																							
DanCaporale	Dan Caporale	1																							
tmj_il_vets	IL Veteran Jobs	0																							
DavidLeeMarti12	David Lee Martin	1																							
Quoimio	n/a	1																							
paramedic123mn	Michael (joker)	1																							
saddletrap	RD Ogg	0																							
createtruespace	n/a	0																							
JoeKnig26762941	Joe Knight	1																							
j_mignereysr	Jerry D. Mignerey	1																							
DeplorablAnnJoy	n/a	0																							
TJforTrump70461	TJforTrump	0																							
BUZZ25or624	BUZZ	1																							
shadowbirddog	J H	1																							
WTFNationRadio	WTF Nation Radio	0		Get userbase?																					
oooonoelleoooo	n/a	0																							
tmj_AZ_vets	AZ Veteran Jobs	0																							
sunflowerwsnc	LdySgt_American	1																							
msusan1030	n/a	0																							
bonbonllc	BB	0																							
rich_gas	RichGas	0																							
Lonestar357	LoneStar	1																							
jacs845	Chris J	1																							
DonnaD1301	Donna H.	1																							
Marvo23927052	n/a	0																							
rayann2320	Eileen	0																							
																									
																									
																									
																									
																									
																									
																									
																									
																									
																									
																									
																									
																									
																									
																									
																									
																									
																									
																									
																									
																									
																									
																									
																									
																									
																									
																									
																									
																									
																									
																									
																									
																									
																									
																									
																									
																									
																									
																									
																									
																									
																									
																									
																									
																									
																									
																									
																									
																									
																									
																									
																									
																									
																									
																									
																									
																									
																									
																									
																									
																									
																									
																									
																									
																									
																									
																									
																									
																									
																									
																									
																									
																									
																									
																									
																									
																									
																									
																									
																									
																									
																									
																									
																									
																									
																									
																									
																									
																									
																									
																									
																									
																									
																									
																									
																									
																									
																									
																									
																									
																									
																									
																									
																									
																									
																									
																									
																									
																									
																									
																									
																									
																									
																									
																									
																									
																									
																									
																									
																									
																									
																									
																									
																									
																									
																									
																									
																									
																									
																									
																									
																									
																									
																									
																									
																									
																									
																									
																									
																									
																									
																									
																									
																									
																									
																									
																									
																									
																									
																									
																									
																									
																									
																									
																									
																									
																									
																									
																									
																									
																									
																									
																									
																									
																									
																									
																									
																									
																									
																									
																									
																									
																									
																									
																									
																									
																									
																									
																									
																									
																									
																									
																									
																									
																									
																									
																									
																									
																									
																									
																									
																									
																									
																									
																									
																									
																									
																									
																									
																									
																									
																									
																									
																									
																									
																									
																									
																									
																									
																									
																									
																									
																									
																									
																									
																									
																									
																									
																									
																									
																									
																									
																									
																									
																									
																									
																									
																									
																									
																									
																									
																									
																									
																									
																									
																									
																									
																									
																									
																									
																									
																									
																									
																									
																									
																									
																									
																									
																									
																									
																									
																									
																									
																									
																									
																									
																									
																									
																									
																									
																									
																									
																									
																									
																									
																									
																									
																									
																									
																									
																									
																									
																									
																									
																									
																									
																									
																									
																									
																									
																									
																									
																									
																									
																									
																									
																									
																									
																									
																									
																									
																									
																									
																									
																									
																									
																									
																									
																									
																									
																									
																									
																									
																									
																									
																									
																									
																									
																									
																									
																									
																									
																									
																									
																									
																									
																									
																									
																									
																									
																									
																									
																									
																									
																									
																									
																									
																									
																									
																									
																									
																									
																									
																									
																									
																									
																									
																									
																									
																									
																									
																									
																									
																									
																									
																									
																									
																									
																									
																									
																									
																									
																									
																									
																									
																									
																									
																									
																									
																									
																									
																									
																									
																									
																									
																									
																									
																									
																									
																									
																									
																									
																									
																									
																									
																									
																									
																									
																									
																									
																									
																									
																									
																									
																									
																									
																									
																									
																									
																									
																									
																									
																									
																									
																									
																									
																									
																									
																									
																									
																									
																									
																									
																									
																									
																									
																									
																									
																									
																									
																									
																									
																									
																									
																									
																									
																									
																									
																									
																									
																									
																									
																									
																									
																									
																									
																									
																									
																									
																									
																									
																									
																									
																									
																									
																									
																									
																									
																									
																									
																									
																									
																									
																									
																									
																									
																									
																									
																									
																									
																									
																									
																									
																									
																									
																									
																									
																									
																									
																									
																									
																									
																									
																									
																									
																									
																									
																									
																									
																									
																									
																									
																									
																									
																									
																									
																									
																									
																									
																									
																									
																									
																									
																									
																									
																									
																									
																									
																									
																									
																									
																									
																									
																									
																									
																									
																									
																									
																									
																									
																									
																									
																									
																									
																									
																									
																									
																									
																									
																									
																									
																									
																									
																									
																									
																									
																									
																									
																									
																									
																									
																									
																									
																									
																									
																									
																									
																									
																									
																									
																									
																									
																									
																									
																									
																									
																									
																									
																									
																									
																									
																									
																									
																									
																									
																									
																									
																									
																									
																									
																									
																									
																									
																									
																									
																									
																									
																									
																									
																									
																									
																									
																									
																									
																									
																									
																									
																									
																									
																									
																									
																									
																									
																									
																									
																									
																									
																									
																									
																									
																									
																									
																									
																									
																									
																									
																									
																									
																									
																									
																									
																									
																									
																									
																									
																									
																									
																									
																									
																									
																									
																									
																									
																									
																									
																									
																									
																									
																									
																									
																									
																									
																									
																									
																									
																									
																									
																									
																									
																									
																									
																									
																									
																									
																									
																									
																									
																									
																									
																									
																									
																									
																									
																									
																									
																									
																									
																									
																									
																									
																									
																									
																									
																									
																									
																									
																									
																									
																									
																									
																									
																									
																									
																									
																									
																									
																									
																									
																									
																									
																									
																									
																									
																									
																									
																									
																									
																									
																									
																									
																									
																									
																									
																									
																									
																									
																									
																									
																									
																									
																									
																									
																									
																									
																									
																									
																									
																									
																									
																									
																									
																									
																									
																									
																									
																									
																									
																									
																									
																									
																									
																									
																									
																									
																									
																									
																									
																									
																									
																									
																									
																									
																									
																									
																									
																									
																									
																									
																									
																									
																									
																									
																									
																									
																									
																									
																									
																									
																									
																									
																									
																									
																									
																									
																									
																									
																									
																									
																									
																									
																									
																									
																									
																									
																									
																									
																									
																									
																									
																									
																									
																									
																									
																									
																									
																									
																									
																									
																									
																									
																									
																									
																									
																									
																									
																									
																									
																									
																									
																									
																									
																									
																									
																									
																									
																									
																									
																									
																									
																									
																									
																									
																									
																									
																									
																									
																									
																									
																									
																									
																									
																									
																									
																									
																									
																									
																									
																									
																									
																									
																									
																									
																									
																									
																									
																									
																									
																									
																									
																									
																									
																									
																									
																									
																									
																									
																									
																									
																									
																									
																									
																									
																									
																									
																									
																									
																									
																									
																									
																									
																									
																									
																									
																									
																									
																									
																									
																									
																									
																									
																									
																									
																									
																									
																									
																									
																									
																									
																									
																									
																									
																									
																									
																									
																									
																									
																									
																									
																									
																									
																									
																									
																									
																									
																									
																									
																									
																									
																									
																									
																									
																									
																									
																									
																									
																									
																									
																									
																									
																									
																									
																									
																									
																									
																									
																									
																									
																									
																									
																									
																									
																									
																									
																									
																									
																									
																									
																									
																									
																									
																									
																									
																									
																									
																									
																									
																									
																									
																									
																									
																									
																									
																									
																									
																									
																									
																									
																									
																									
																									
																									
																									
																									
																									
																									
																									
																									
																									
																									
																									
																									
																									
																									
